20 2
11100000000000000000
01100000000000000000
01111121111111131111
00000000000000000022
11111111311131111111
45000000000000000000
11111111111111111111
00000000000000056111
00000000000001111000
00000000000161100000
00000000011110000000
00000001114000000000
00000011111111141141
00000212111111111111
00001111110000000000
00011111100000000000
00011110000000000000
00001111100000000000
00000181000000000000