20 1
00000000000000000000
00000000010000000000
00000000111000000000
00111111111111111100
21111211131111111112
11111111111111111111
11111111111111111111
31111311113111113111
11111111111111111111
11111111111111111111
41141141141141141114
11111111111111111111
11111111111111111111
51151151151151151115
11111111111111111111
11111111111111111111
00111111111111111100
00000000111000000000
00000000090000000000
