25 1
0000000000000000000000000
1111111111111211111111000
1111111111311311111111000
1111111114511112131140000
0000000001100000000000000
0000000001100000000000000
0000000001100000000000000
1111111111111111111111111
1112111411132111131111111
1111111111111111111111111
1111111111111111111111111
0000000011100000000000000
0000000011100000000000000
0000000001110000000000000
0000000001111121131111141
0000000001111121131111141
0000000000000000000000011
0000000000000000000000011
1611121111311114111161111
1611121111311114111161111
1611121111311114111161111
0000000001110000000000000
0000000001210000000000000
0000000001710000000000000