15 2
111111111111111
111111711111111
111111111111011
111111111111011
000000000111011
111111111111011
101311111111016
101111111111011
101111411111011
101111111111111
101111100000001
101111111111111
101111111111111
111111111111111
111111111111111