20 0
11111111111111111111
11111111111111111111
11111111111111111111
11111111111101111111
11101111111101111111
11110111111101111111
11111234561101111111
11111111111111111111
11111111111111111111
11111111111111111111
11111110000000111511
11111111111111111111
11111111111111111111
11111111111111111111
11112111111111131111
11111111111111111111
01111111111151111111
00101111116191111111
00011111111111111111
10001111111111111111