20 0
11111111111111011111
11111111112111111111
11100111111111111111
11111121111111113111
11111111111101111111
11111111111101111111
12111110000111111111
11110000110001111411
11110111111100011111
11100111191111011111
11100011111111001111
11111001111111001111
11111100011110000111
11111111000011111111
11111111111111111111
11110111111111111011
11111111131111111111
11000001111111161111
11111111111111110111
21111111111111111111