20 0
11111111111111011111
11111111111111111111
11100111111111111111
11111111111111111111
11111111111101131111
11161111111101111111
11111111111111111111
11111111111111111111
11111111111111111111
11101111121111011111
11111111111111111111
00111011111111111111
10011111111111111111
11001111111011111111
01100051111111111111
11110110161111111011
11911111011111111111
11100000011111111111
11001111111111110111
11011111111111111111