20 6
11110111111111101111
11101111111111110111
11011111111111111011
10111111111111111101
01111111111111111110
11111111111111111111
11111111111111111111
11111111101111111111
11111111100111111111
11111100000000111111
11110000000000001111
11111100000000111111
11111111101111111111
11111111101111111111
11111111111111111111
01111111111111111110
10111111111111111101
11011111111111111011
11101111111111110111
11110111111111101111