15 0
111111111111111
111111911111111
111111111111011
111111111111011
000000000111011
111111111111011
101111111111011
101111111111011
101111111111011
101111111111111
101111100000001
101111111111111
101111111111111
111111111111111
111111111111111